+---------+                                                                   
|.........|                                                                   
|.........|                                                                   
|.........+-------+                                                           
|.................|                                                           
|.................|                                                           
|.................+-------+                                                   
|.........................|                                +---------+        
|.........................|                                |.........|        
|.........................+------+       ##########        |.........|        
|................................|       #        #        |.........|        
|................................|       #        #        |.........+-------+
|................................#########        #        |.................|
+--------------------------------+    #    +------#--------+ ................|
                                      #    |.........................+-------+
                                      #    |.........................|        
                     ##################    +---#-------+.............|        
                     #                         #       |.............|        
                     #                         #       |.............|        
                     ###########################       +-------------+        
